1 1
#########
# ##### #
# ##### #
#       #
#########